SO                Textures/bendi.xpm
NO            Textures/chaos.xpm
WE          Textures/Sonicxpm
EA             Texture/sonicchouf.xpm

C            6,5,8
F             255,5,90

11111111111111111
100000000000000001
10000111111111111
1000N1
111111