SO Textures/freaky.xpm
NO Textures/silenthillwall.xpm
WE Textures/silent.xpm
EA Textures/affiche.xpm

F 92,91,89
C 1,10,36



111111111111111111111111111111
100000000000001000000000000001
101111111111011011111111111101
101000020001000000000000200101
101011111011011111111101101101
101010001010000000100001100001
100010201010111110101100001101
111111011000100010001111011101
100000011101102011011100000001
101111000001100011000001111101
100000000000000000000000000001
101001111011110111101111000101
101000010000000000000010020101
101110111111110111111111011101
100000000000000000000000000001
101111110111110111110111111101
101000200100000000000100000101
101011111101111111101101110101
10000000000000N000000000002001
111111111111111111111111111111



