SO Textures/freaky.xpm
NO Textures/silenthillwall.xpm
WE Textures/silent.xpm
EA Textures/affiche.xpm

F 8,10,12
C 30,35,30

111111111111111111111111111111
100000000011111000000000000001
101111111011111011111111111101
101000001000000010000000000101
101000001011111010111111110101
101110111010001010100000010101
100000000010001010100000010001
101110111110001010111101111101
101000000011011010000000000101
101011111000000010111111110101
101010001111111110100000010101
100010000000000000100000010001
111111111011111111111101111111
100000000000000000000000000001
100000000000000000000000000001
101111111011111110111111111101
101000001010000010100000000101
101000001010000010100000000101
10000000000000N000000000000001
111111111111111111111111111111



