SO Textures/barriere.xpm
NO Textures/maison.xpm
WE Textures/whoisbro.xpm
EA Textures/bathomer.xpm

C 135,206,235
F 124,252,0


1111111111111111111111111111111
1000000000000000000000000000001
1000020000000000000000000200001
1111111111001111100111111111111
1000000010000000100000001000001
1000000010002000100000000000001
1002000000000000100000001000001
1111001111111001111110011111111
1000000010000000100000001000001
1000000000000000000020001000001
1000000010000000100000001000001
1111111111110011111111111111111
1000000000000000000000000000001
100000000000N000000000000000001
1111111111000011111111111111111
1000000000000000000000000000001
1000200000000000000000020000001
1000000000000000000000000000001
1111111111111111111111111111111